#####   #####
#...#   #...#
#...#   #...#
#...#####...#
#...........#
#...........#
#############