#########
#..#....#
#..#....#
#..#..###
#.....#  
#.....#  
#######  